00000000000000022222
00000000011110022222
00000001110010022222
00000011000010022222
00000010000010022222
11100010000010022222
00100010000010022222
00100010000010022222
00100010000010022222
00100011000011022222
00100001110001122222
00110000010000022222
00011000010000022222
00001111110000022222
00000000000000022222