01000000000000022222
01000111111111022222
01000100000001022222
01000100000001022222
01111100011111022222
00000000010000022222
00000000010000022222
00011111110000022222
00010000000000022222
00010000000000022222
00010011110000022222
00010010010000022222
00011110011111122222
00000000000000022222
00000000000000022222